S...................#
.#.#.#.#####.###.#..#
.#.....#...#...#.#.##
.#.#####.#.###.#.#..#
.#.....#.#.....#.#E.#
.###.#.#.#######.##.#
.....#.#.........#..#
#####.#.##.########.#
#.....#.............#
#####################
